######################
#                    #
#  O              O  #
#  X                 #
#        X           #
###########          #
          #          #
	  #          #
	  #          #
	  #          #
	  #     P X  #
	  #O         #
	  ############